28 38 30 28 29 30 28 29 30 28 38 30 28 29 30 28 38 30 28 29 38 28 29 30 28 29 30 28 29 30 28 29 30 3 29 30 28 29 3 28
36 37 38 36 37 38 36 37 38 36 37 38 36 37 38 36 37 38 36 37 38 36 37 38 36 37 38 36 37 38 36 37 38 36 37 38 36 37 38 36
44 45 38 44 45 46 38 45 46 44 38 46 44 45 46 44 45 46 38 45 46 44 45 46 44 38 46 44 45 46 44 3 46 44 45 46 14 45 46 3
28 29 30 28 29 30 28 29 30 28 29 30 28 38 30 28 29 30 28 29 30 28 29 30 28 29 30 28 29 30 38 38 30 28 29 30 28 29 30 28
36 37 38 36 38 38 36 37 38 36 37 38 36 37 38 36 37 38 36 37 38 36 37 38 36 37 38 36 37 3 36 37 38 36 37 38 36 37 38 36
44 45 46 44 45 46 44 45 38 44 45 46 44 45 46 44 45 46 38 45 46 44 45 46 44 45 46 44 45 46 44 45 46 44 45 46 44 45 3 44
28 29 30 28 29 30 28 29 30 28 29 30 28 29 30 28 29 30 28 29 30 28 29 30 38 29 30 28 29 30 28 29 30 28 29 30 28 29 30 28
36 37 38 36 37 38 36 37 38 36 37 38 36 37 38 36 37 38 36 37 38 38 37 38 36 37 38 36 37 38 36 37 38 36 37 3 36 37 38 36
44 45 46 44 45 46 44 45 46 44 45 46 44 45 46 44 45 46 44 45 46 44 45 46 44 45 46 44 45 46 44 45 46 44 45 46 44 45 46 44
28 29 30 38 29 30 28 29 30 28 29 30 28 29 30 28 29 30 28 29 30 28 29 30 28 29 30 28 29 30 28 29 30 28 29 30 28 29 30 28
36 37 38 36 37 38 36 37 38 36 37 38 36 37 38 36 37 38 36 37 38 36 37 38 36 37 38 36 37 38 36 37 38 36 37 38 36 37 38 36
44 45 38 44 45 46 44 45 46 44 45 46 44 45 46 44 45 46 44 45 46 44 45 46 44 38 46 44 45 46 44 45 46 44 45 46 44 45 46 44
28 29 30 28 29 30 28 29 30 28 29 30 28 29 30 28 29 30 28 29 30 28 29 30 28 29 30 28 29 30 28 29 30 28 29 30 28 29 30 28
36 38 38 36 38 38 36 37 38 36 37 38 36 37 38 36 37 38 36 37 38 36 37 38 73 41 41 81 37 38 36 37 38 36 37 38 36 37 38 36
44 45 46 44 45 46 44 45 46 44 45 46 44 45 46 44 45 46 44 45 46 44 45 73 49 49 49 89 45 46 44 45 46 44 45 46 44 45 46 44
28 29 30 28 29 30 28 29 30 28 29 30 28 29 30 28 29 30 28 29 30 28 73 49 49 57 49 89 29 30 38 29 30 28 29 30 28 29 30 28
25 25 25 25 25 25 25 25 25 25 25 25 25 25 41 25 25 25 25 25 25 25 49 57 49 49 49 89 37 38 36 37 38 36 37 38 36 37 38 36
49 49 49 49 57 49 49 49 49 49 49 49 49 49 49 49 49 49 49 57 49 49 49 49 49 49 97 44 45 46 44 45 46 44 38 46 44 45 46 44
49 57 49 49 49 49 49 57 49 49 49 57 49 57 49 49 49 49 49 49 49 49 65 65 65 97 30 28 29 38 28 29 30 28 29 30 28 29 30 28
65 65 65 65 65 65 65 65 65 65 65 65 65 65 65 65 65 49 49 49 49 97 37 38 36 37 38 36 37 38 36 37 38 36 37 38 36 37 38 36
44 45 46 44 45 46 44 45 46 44 45 46 44 45 46 44 45 49 57 49 89 44 45 46 44 45 46 44 45 46 44 45 46 44 38 46 44 45 46 44
60 60 60 60 60 60 60 60 60 60 60 60 60 60 60 60 60 49 49 49 89 3 29 30 28 29 87 28 29 30 28 29 30 28 29 30 28 29 30 28
17 6 17 17 17 17 17 17 17 17 17 17 17 17 17 17 60 49 49 57 89 36 37 38 36 80 17 108 108 86 86 37 38 36 37 38 36 37 38 36
17 17 17 17 17 17 17 17 17 17 17 17 9 17 6 17 60 49 49 49 89 3 45 46 44 17 17 6 6 6 17 17 17 17 38 46 44 45 46 44
17 17 12 17 17 17 17 12 17 17 17 17 17 17 17 17 60 49 57 49 89 28 29 37 38 17 12 17 17 17 17 6 17 17 29 30 28 29 30 28
17 17 17 17 17 17 17 17 17 17 17 17 17 17 17 17 60 49 49 49 89 3 37 38 17 17 17 17 17 9 17 17 17 17 17 38 36 37 38 36
17 17 17 17 17 17 17 17 17 17 17 9 17 17 17 17 60 49 49 49 89 44 45 37 17 17 17 17 17 17 17 17 5 17 17 46 44 45 46 44
17 17 17 5 17 17 17 17 17 17 17 17 5 17 6 17 29 65 65 65 97 28 29 37 38 17 17 5 17 17 5 17 17 17 29 30 28 29 30 28
17 17 17 17 17 17 12 17 17 17 17 17 17 17 17 17 37 38 36 37 38 36 37 37 38 17 17 17 17 17 17 17 17 17 37 38 36 37 38 36
17 6 17 17 17 17 17 17 17 17 6 17 17 17 17 17 45 46 44 45 46 44 45 37 38 17 17 17 17 17 5 17 17 44 45 46 44 45 46 44
17 17 9 17 17 17 17 17 17 17 17 17 12 17 17 17 29 30 28 29 30 28 29 30 17 5 17 17 17 17 17 29 30 28 29 30 28 29 30 28
17 17 17 17 17 17 17 17 17 17 17 17 17 17 17 17 43 44 14 46 47 36 37 17 17 17 17 36 37 38 36 37 38 36 38 38 36 37 38 36
17 17 17 17 17 5 17 17 17 17 17 17 17 17 17 17 51 52 53 54 55 72 17 17 17 17 17 44 45 46 44 45 38 44 45 46 44 45 46 44
17 17 17 17 17 17 17 17 9 17 17 17 5 17 17 17 59 60 60 60 63 72 17 17 6 5 30 28 38 30 38 29 30 28 29 30 28 29 30 28
17 6 17 17 17 17 17 17 17 17 17 17 17 17 17 66 67 70 70 70 71 72 17 12 12 17 38 36 37 38 36 37 38 36 37 38 36 37 38 36
17 6 17 17 17 17 17 17 17 17 17 6 17 17 17 74 75 77 77 77 79 17 6 17 17 17 46 44 38 46 44 45 46 44 45 46 44 45 46 44
17 17 17 12 17 17 17 17 17 5 17 17 17 17 17 17 83 84 85 86 87 17 17 6 17 29 30 28 38 30 28 29 30 28 29 30 28 29 30 28
17 17 17 17 17 17 17 17 17 17 17 17 17 17 17 5 17 17 17 17 17 17 17 17 36 37 38 36 37 38 36 37 38 14 37 38 36 37 38 36
17 17 17 17 6 17 17 17 17 17 12 17 6 17 17 17 17 17 17 5 17 17 17 17 44 45 46 38 45 46 44 45 46 44 45 46 44 45 46 44
17 17 17 17 17 17 17 17 17 17 17 17 17 17 17 17 17 17 9 6 17 17 29 30 28 29 30 28 29 30 28 29 30 28 29 30 28 29 30 28
